R 1080 720
NO ./textures/northtexture.xpm
SO ./textures/southtexture.xpm
WE ./textures/westtexture.xpm
EA ./textures/easttexture.xpm
S ./textures/sprite.xpm
F 255, 255, 0
C 225, 255, 255

        1111111111111111111111111
        1000000000110000000022201
        1011000001110000002200001
        1001000000000000000002001
111111111011000001110000000000001
100000000011000001110111110111111
11110111111111011100000010001
11110111111111011101010010021
11000000110101011100000010021
10002000000000001100000010021
10000000000000001101010010201
11000001110101011111011110N0111
11110111 1110101 101111010001
11111111 1111111 111111111111